YGYGYGYGYGY
RRRYYRYRRRR
RYYRYRYRYYY
RYYRYRYRRRR
RYYRYRYRYYY
RRRYYRYRRRR
GYGYGYGYGYG
***********
***********
***********

*TB*