RRRRRRRRRRR
SSSSSSSSSSS
YYYYYYYYYYY
GGGGGGGGGGG
BBBBBBBBBBB
PPPPPPPPPPP
***********
***********
***********
***********

*BB*