R*R*R*R*R*R
*Y*Y*Y*Y*Y*
G*G*G*G*G*G
*B*B*B*B*B*
***********
***********
***********
***********
***********
***********

*BB*