YYYYYYYYYYY
YRYYRYYRRRY
YRYYRYYYRYY
YRRRRYYYRYY
YRYYRYYYRYY
YRYYRYYRRRY
YYYYYYYYYYY
***********
***********
***********

BBTB